WWWWWWWWWWWWWWWWW
W    W     W    W
W    W     W    W
W    S     W    W
W        VWWWV  W
W        WWWWW  W
W          W    W
W          W    W
W          W    W
WWWWWWWWWWWW    W
W          W    W
W          W    W
WWV        WWWWWW
W          W
W          W
WWWWWWWWWWWW